NO assets/DOOM_W1_116.xpm
EA assets/DOOM_W3_161.xpm
SO assets/DOOM_W4_212.xpm
WE assets/DOOM_W2_117.xpm


F 92,97,103
C 193,10,0

           1111111111111111111111111111111111111111111111111111111111111111111111111111111111111111111111111111111111111111111111111111111111111111111111111111111111111111111111111111111111111111
           1011000001110000000000000000000000100000000000000000000000000000000000000000000000000000000D00000000D00000000D0000000D00000000D0000000D00000000D0000000D00000000D0000000D00000000D0000011
           100000000011000000000000000000000000000000000001000000000000000000000000000000000000000000010111111111111111111111111111111111111111111111111111111111111111111111111111111111111111100001
           10010000000000000000001110000000000000000000000000000100000000000000000000000000000000000001D1                                                                                      1000001
111111111111000001110000000000001000000000000000000000010000000000000000000000000000000000000000100000101                                                                                      10000001
1000000000000000000000000000100000000001000000000000000000000000000001000000000000000000000000000000001D1                                                                                      100000001
100000000011000001110111111111111000000111111111111111110000000000010000000001100000000000000000000000101                                                                                      1000000001
100000000000000000000000000010000000000D000000000000000111110000000000000111110000111111000001110001101D1                                                                                      10000000001
1000000000000000000000000000100000000001000000010000000D000D000000E00000011111000011111100000111000110101                                                                                      100000000001
100000000000000000000000000010000000000D000000000000000111110000000000000111110000111111000001110001101D1                                                                                      1000000000001
10000000000000000000000000001000000000011111111111D111110000000000000000011111000011111100000111000110101                                                                                      1000000000000111111111111111111111111111111111111111111111111111111111111111111111111111
100000000011000001110111111111111000000000000000010100010000000000010000000001100000000000000000000000101                                                                                      100000000001000D0000000D00000D0000D00D00100000000000001000000000000000000000000000000101
1000000000000000000000000000100000000001000000000101000000000000000000000111110000111111000001110001101D1                                                                                      1000000000100011111111111111111111111100100000000000000100000000000001000000000000000101
100000000000000000000000000010000000000100000000010100000000000000000000011111000011111100000111000110101                                                                                      10000000010001000000000000D0000000000000100000001000000000000001000000000000100000000101
1000000000000000000000000000100000000001000000000101000000000000000000000111110000111111000001110001101D1                                                                                      1000000010001000000000000010000000000000100000000000000001000000000000000111100000000D01
100000000000000000000000000010000000000100000000010100000000000000000000011111000011111100000111000110101                                                                                      1111D11110001111111111111D1111111111111D11111111D111111111111111111111111111111111111111
10000000001100000111011111111111100000000000000001D100010000000000010000000000D00000000000000000000000101                                                                                      10000000D0000000000000000000000000000000000000000000000000000000000000000000000000000001
1000000000000000000000000000100000000001000000000101000000000000000000000111110000111111000001110001101D1                                                                                      1111111111111111111111111111111111111111111111111111111111111111111111111111111111111111
100000000000000000000000000010000000000100000000010100000000000000000000011111000011111100000111000110101
1000000000000000000000000000100000000001000000000101000000000000000000000111110000111111000001110101101D1
10000000000000000000000000001000000000010000000001D11111111111100000000000000D000000000D00000011000110101
11110111111111011100000010001000000000010000000001000000000000D000000000011111000011111100000111000110101
11110111111111011101010010001000000000010000000001111111D111111100000000011111000011111100000111000110101
11000000110101011100000010001000000000010000000001     D0D     1000000000111110000111111000001110001101D1
10000000000000001100000000010000000000010000000001     D0D     10000000000000D000011111100000111010110101
100000000000000011010100D0001000000000010000000001     D0D     100000000011111000011111100000111000110101
11000001110101011111011110001110000000000100000001     D0D     100000000000000000011111100000111000110101
11110111 1110101 101111010001000000000010000000001     D0D     1000000000111110000111111000001110001101D1
11111111 1111111 111111111111111011111111111111111D11111D111111111111111111111111111111111111111111110101
11110111 1110101 1011110100010000000000100000000000000000000000000000000000000000000000000000000000000D01
11111111 1111111 1111111111111111111111111111111111111111111111111111111111111111111111111111111111111111