NO assets/N.xpm
EA assets/N2.xpm
SO assets/S.xpm
WE assets/W.xpm


F 200,100,12
C 135,206,235


















           1111111111111111111111111
           1011000001110000000000001
           1000000000110000000000001
           1001000000000000000000111
111111111111000001110000000000001
100000000011000001110111111111111
11110111111111011100000010001
1111D111111111011101010010001
11000000110101011100000010001
10000000000000001100000000001
10000000000000001101010010001
11000001110101011111011110N0111
11110111 1110101 101111010001
11111111 1111111 111111111111