NO assets/N.xpm
EA assets/E.xpm
SO assets/S.xpm
WE assets/W.xpm


F 200,100,1
C 225,30,0


1111111111111111111111111111111111111111111111111111111111
1000000000000000000000000000000000000000000000000000000001
1000000000000000000000000000000000000000000000000000000001
1000000000000000000000000000000000000000000000000000000001
1000000000000000000000000000000000000000000000000000000001
1000000000000000000000000000000000000000000000000000000001
1000000000000000000000000000000000000000000000000000000001
1000000000000000000000000000000000000000000000000000000001
1000000000000000000000000000000000000000000000000000000001
1000000000E000000000000DDDDDDDDDDDDDDD00000000000000000001
10000000000000000000000DDDDDDDDDDDDDDD00000000000000000001
10000000000000000000000DDDDDDDDDDDDDDD00000000000000000001
10000000000000000000000DDDDDDDDDDDDDDD00000000000000000001
10000000111000000000000DDDDDDDDDDDDDDD00000000000000000001
100000001 1000000000000DDDDDDDDDDDDDDD00000000000000000001
10000000111000000000000DDDDDDDDDDDDDDD00000000000000000001
10000000000000000000000DDDDDDDDDDDDDDD00000000000000000001
10000000000000000000000DDDDDDDDDDDDDDD00000000000000000001
10000000000000000000000DDDDDDDDDDDDDDD00000000000000000001
1111111111111111111111111111111111111111111111111111111111